|||||....................|||||....................
|...|....................|...|....................
|||||...............||||||||||....................
....................|...|.........................
....................|||||...............|||||.....
...........|||||........................|...|.....
...........|...|..........|||||.........|||||.....
...........|||||..........|...|..............|||||
..........................|||||..............|...|
.............................................|||||
