............................................................
...|..........|..............|..........|................|..
...|....|.....|..............|....|.....|................|..
...|..|....||||||||..........|..|....||||||||.......||||||||
......|....|.....|.||||.........|....|.....|...|.||||....|..
......|....|.........|..........|....|.............|........
......|....|....................|....|......................
......|....|||||||||...|........|....|||||||||||||.....||||.
...............|.......|.................|...|.........|....
........|..............|..........|.........................
.......................|....................................
...|..........|........|.....|..........|...................
...|....|.....|..............|....|.....|...................
...|..|....||||||||..........|..|....||||||||||||......||||.
......|....|.....|.||||.........|....|.....|...|.||||....|..
......|....|.........|..........|....|.............|........
......|....|....................|....|......................
.......................|....................................
...|..........|........|.....|..........|...................
......|....|||||||||............|....|||||||||||||.....||||.
...............|.........................|...|.........|....
........|...............|.........|.........................
......|....|....................|....|......................
......|....|||||||||............|....|||||||||||||.....||||.
...............|.........................|...|.........|....
........|...............|.........|.........................
