....|||||....................|||||....................
....|...|....................|...|....................
....|||||...............||||||||||....................
........................|...|.........................
........................|||||...............|||||.....
...............|||||........................|...|.....
...............|...|..........|||||.........|||||.....
...............|||||..........|...|..............|||||
..............................|||||..............|...|
.................................................|||||
|||||....................|||||........................
|...|....................|...|........................
|||||...............||||||||||........................
....................|...|.............................
....................|||||...............|||||.........
...........|||||........................|...|.........
...........|...|..........|||||.........|||||.........
...........|||||..........|...|..............|||||....
..........................|||||..............|...|....
.............................................|||||....
